 ####
 #  #####
 #   $  #
 #$# #  #
##  +  ##
#  #.#$#
#  $.  #
### . ##
  #####
