  #######
 ##  #  #
 # * *  #
##   #  #
#  *#+ ##
#     $#
#####  #
    ####
