   ####
 ###  #
## @$ #
# .$  #
# .* ##
# .$ #
##  ##
 ####
