  #####
###   #
#  *# ##
# #  * #
# *  # #
## #+  #
 #   $##
 ###  #
   ####
