  #####
  #   #
###*# ##
#    * #
# #  # #
# * +  #
##  #$##
 ##   #
  #####
