########
#   *  #
# +*** #
##  $  #
 ##   ##
  ##  #
   ####
