 ####
 #  #
##.@#
# .$#####
# $$ $  #
# ..    #
####  ###
   ####
