  #####
###   ##
# $$.. #
#  .@# #
## #   #
 # $* ##
 ###  #
   ####
