  #####
###  @#
#  $  #
#    #########
# #$   ....  #
#  $ ######$ #
##  ##    #  #
 ####     ####