 #####
 # @ ###
## #$  #
# *. . #
#  $$ ##
### #.#
  #   #
  #####
